market,ma,ngay,khoi_luong_mua,gia_tri_mua,khoi_luong_ban,gia_tri_ban,khoi_luong_giao_dich_rong,gia_tri_giao_dich_rong,room_con_lai,dang_so_huu
HOSE,VPB,2022-11-21,4021860,62338830000,500912,7764136000,3520948,54574694000,266261,
HOSE,HPG,2022-11-21,8434000,126088300000,4955175,74079866250,3478825,52008433750,1699353378,
HOSE,FUEVFVND,2022-11-21,5268200,107102506000,2198000,44685340000,3070200,62417166000,15708648,
HOSE,MBB,2022-11-21,3235543,50798025100,1089002,17097331400,2146541,33700693700,15708648,
HOSE,POW,2022-11-21,2268600,23366580000,149100,1535730000,2119500,21830850000,1052838077,
HOSE,EIB,2022-11-21,820200,14804610000,100000,1805000000,720200,12999610000,78365489,
HOSE,NLG,2022-11-21,3446100,79432605000,2751888,63431018400,694212,16001586600,27889081,
HOSE,KBC,2022-11-21,861700,14476560000,318500,5350800000,543200,9125760000,244360374,
HOSE,VNM,2022-11-21,1319342,102776741800,803404,62585171600,515938,40191570200,924398053,
HOSE,SHB,2022-11-21,477600,4967040000,6500,67600000,471100,4899440000,661804002,
HOSE,SBT,2022-11-21,430000,4622500000,42900,461175000,387100,4161325000,575614605,
HOSE,VND,2022-11-21,997500,11271750000,646350,7303755000,351150,3967995000,1000005876,
HOSE,MSN,2022-11-21,578756,55039695600,246540,23445954000,332216,31593741600,273067287,
HOSE,KDH,2022-11-21,540800,12113920000,213330,4778592000,327470,7335328000,105856240,
HOSE,VCI,2022-11-21,594900,11243610000,294186,5560115400,300714,5683494600,356576227,
HOSE,BID,2022-11-21,337500,11981250000,36900,1309950000,300600,10671300000,655677729,
HOSE,HDB,2022-11-21,848344,12555491200,550405,8145994000,297939,4409497200,32,
HOSE,NT2,2022-11-21,338300,8203775000,84060,2038455000,254240,6165320000,96020365,
HOSE,SSI,2022-11-21,1147400,18473140000,905680,14581448000,241720,3891692000,934208243,
HOSE,HHS,2022-11-21,161100,550962000,0,0,161100,550962000,154634594,
HOSE,GMD,2022-11-21,204900,8564820000,46200,1931160000,158700,6633660000,2111542,
HOSE,PVD,2022-11-21,148900,1987815000,11900,158865000,137000,1828950000,180232577,
HOSE,HQC,2022-11-21,149800,307090000,19400,39770000,130400,267320000,226237461,
HOSE,VIC,2022-11-21,450150,28809600000,330476,21150464000,119674,7659136000,1386954676,
HOSE,TNH,2022-11-21,112700,3448620000,1510,46206000,111190,3402414000,5246069,
HOSE,HNG,2022-11-21,138800,599616000,30984,133850880,107816,465765120,534215933,
HOSE,PDR,2022-11-21,94900,1622790000,0,0,94900,1622790000,308842968,
HOSE,PVT,2022-11-21,164500,2648450000,71700,1154370000,92800,1494080000,103110651,
HOSE,SAM,2022-11-21,92200,570718000,0,0,92200,570718000,176382369,
HOSE,NVL,2022-11-21,227800,6207550000,140001,3815027250,87799,2392522750,851861249,
HOSE,DHC,2022-11-21,74800,2692800000,0,0,74800,2692800000,12010299,
HOSE,VHC,2022-11-21,74502,4961833200,100,6660000,74402,4955173200,127896124,
HOSE,GEX,2022-11-21,128600,1710380000,69900,929670000,58700,780710000,343477203,
HOSE,PLX,2022-11-21,70200,1776060000,12700,321310000,57500,1454750000,34460594,
HOSE,STK,2022-11-21,50000,1305000000,0,0,50000,1305000000,73643765,
HOSE,TLH,2022-11-21,70900,407675000,26000,149500000,44900,258175000,48736211,
HOSE,TV2,2022-11-21,42500,833000000,0,0,42500,833000000,45465,
HOSE,AAA,2022-11-21,110000,770000000,68100,476700000,41900,293300000,372396569,
HOSE,LHG,2022-11-21,44600,834020000,3200,59840000,41400,774180000,18131966,
HOSE,FUESSVFL,2022-11-21,39900,492366000,1500,18510000,38400,473856000,7622700,
HOSE,BWE,2022-11-21,67100,2576640000,29200,1121280000,37900,1455360000,60201704,
HOSE,SZC,2022-11-21,83200,2217280000,48300,1287195000,34900,930085000,46154640,
HOSE,SAB,2022-11-21,38200,6975320000,6700,1223420000,31500,5751900000,239284411,
HOSE,VCG,2022-11-21,225900,3207780000,195130,2770846000,30770,436934000,222327779,
HOSE,KSB,2022-11-21,107600,1544060000,77200,1107820000,30400,436240000,32073460,
HOSE,VJC,2022-11-21,60900,6126540000,31204,3139122400,29696,2987417600,73167779,
HOSE,HAP,2022-11-21,65500,305230000,40000,186400000,25500,118830000,51513816,
HOSE,HVN,2022-11-21,35664,333458400,11100,103785000,24564,229673400,532934837,
HOSE,JVC,2022-11-21,23900,70027000,0,0,23900,70027000,53611319,
HOSE,BFC,2022-11-21,27800,430900000,4300,66650000,23500,364250000,25853266,
HOSE,DHA,2022-11-21,31600,875320000,10500,290850000,21100,584470000,5130784,
HOSE,SJD,2022-11-21,22700,329150000,2500,36250000,20200,292900000,23454484,
HOSE,TPB,2022-11-21,19000,391400000,30,618000,18970,390782000,31523,
HOSE,GVR,2022-11-21,115000,1495000000,96400,1253200000,18600,241800000,497804815,
HOSE,FUESSV30,2022-11-21,20000,235400000,1600,18832000,18400,216568000,3357270,
HOSE,VPI,2022-11-21,24000,1324800000,6100,336720000,17900,988080000,116256747,
HOSE,SMB,2022-11-21,17600,716320000,0,0,17600,716320000,10368845,
HOSE,FMC,2022-11-21,17600,558800000,1000,31750000,16600,527050000,12126424,
HOSE,BIC,2022-11-21,17700,474360000,2000,53600000,15700,420760000,2585344,
HOSE,EVF,2022-11-21,14100,91650000,0,0,14100,91650000,175213324,
HOSE,UDC,2022-11-21,12600,79380000,0,0,12600,79380000,12825820,
HOSE,FUEVN100,2022-11-21,62100,737748000,50400,598752000,11700,138996000,12969870,
HOSE,BCM,2022-11-21,12500,956250000,1100,84150000,11400,872100000,476263675,
HOSE,PGC,2022-11-21,10600,179140000,0,0,10600,179140000,26461965,
HOSE,TVB,2022-11-21,12400,47120000,1900,7220000,10500,39900000,30809688,
HOSE,PPC,2022-11-21,11900,147560000,3000,37200000,8900,110360000,117140254,
HOSE,VNE,2022-11-21,8100,74115000,0,0,8100,74115000,38943741,
HOSE,ADS,2022-11-21,8900,83571000,1000,9390000,7900,74181000,21409998,
HOSE,AST,2022-11-21,7600,379240000,200,9980000,7400,369260000,2035582,
HOSE,KOS,2022-11-21,6700,241200000,0,0,6700,241200000,105986843,
HOSE,AMD,2022-11-21,6500,7280000,0,0,6500,7280000,78165891,
HOSE,HAH,2022-11-21,10600,296800000,4500,126000000,6100,170800000,24414693,
HOSE,TCL,2022-11-21,8300,229495000,2400,66360000,5900,163135000,13347281,
HOSE,MSB,2022-11-21,7100,84135000,1300,15405000,5800,68730000,8558,
HOSE,FIR,2022-11-21,5700,273600000,300,14400000,5400,259200000,21848023,
HOSE,CMG,2022-11-21,6500,232050000,1100,39270000,5400,192780000,11835094,
HOSE,TRA,2022-11-21,5000,472500000,0,0,5000,472500000,1273141,
HOSE,NSC,2022-11-21,5100,354450000,100,6950000,5000,347500000,7114690,
HOSE,TCR,2022-11-21,4000,11360000,0,0,4000,11360000,296216,
HOSE,FPT,2022-11-21,3900,273390000,100,7010000,3800,266380000,296216,
HOSE,FUESSV50,2022-11-21,8100,89181000,4600,50646000,3500,38535000,7050642,
HOSE,SKG,2022-11-21,3600,48420000,300,4035000,3300,44385000,7781915,
HOSE,GDT,2022-11-21,4100,128945000,1100,34595000,3000,94350000,5139075,
HOSE,NAF,2022-11-21,3000,25020000,0,0,3000,25020000,46734000,
HOSE,ITD,2022-11-21,2700,32940000,0,0,2700,32940000,10123909,
HOSE,TVT,2022-11-21,2800,67200000,100,2400000,2700,64800000,9451710,
HOSE,YEG,2022-11-21,9600,82176000,6900,59064000,2700,23112000,26300724,
HOSE,BVH,2022-11-21,25100,1197270000,22740,1084698000,2360,112572000,167200605,
HOSE,HTN,2022-11-21,2800,47040000,500,8400000,2300,38640000,42954027,
HOSE,SHI,2022-11-21,2500,37000000,300,4440000,2200,32560000,79286185,
HOSE,LBM,2022-11-21,2100,85680000,0,0,2100,85680000,7333902,
HOSE,D2D,2022-11-21,2300,46460000,200,4040000,2100,42420000,14020866,
HOSE,TCM,2022-11-21,4100,184090000,2000,89800000,2100,94290000,2011445,
HOSE,ANV,2022-11-21,2000,38600000,0,0,2000,38600000,57489644,
HOSE,NVT,2022-11-21,2000,13180000,0,0,2000,13180000,45148480,
HOSE,VIB,2022-11-21,2000,37000000,0,0,2000,37000000,45148480,
HOSE,CDC,2022-11-21,1900,33820000,0,0,1900,33820000,10675413,
HOSE,VNL,2022-11-21,1700,33490000,0,0,1700,33490000,3735120,
HOSE,DLG,2022-11-21,1600,3008000,0,0,1600,3008000,141344633,
HOSE,RAL,2022-11-21,1500,108750000,0,0,1500,108750000,10870290,
HOSE,CLC,2022-11-21,1400,46130000,0,0,1400,46130000,12281554,
HOSE,SGN,2022-11-21,1300,68510000,100,5270000,1200,63240000,9247584,
HOSE,BMC,2022-11-21,1100,11935000,0,0,1100,11935000,5286087,
HOSE,PAC,2022-11-21,1100,33990000,0,0,1100,33990000,16825569,
HOSE,TDH,2022-11-21,1000,2950000,0,0,1000,2950000,53704099,
HOSE,TCO,2022-11-21,1000,8920000,0,0,1000,8920000,8714944,
HOSE,DMC,2022-11-21,900,38610000,0,0,900,38610000,15589890,
HOSE,VRC,2022-11-21,900,6057000,0,0,900,6057000,24271414,
HOSE,EVE,2022-11-21,6700,89780000,5900,79060000,800,10720000,11807644,
HOSE,C32,2022-11-21,800,14000000,0,0,800,14000000,6695353,
HOSE,BCE,2022-11-21,800,4352000,0,0,800,4352000,16668088,
HOSE,TMP,2022-11-21,700,35350000,0,0,700,35350000,33912380,
HOSE,TCT,2022-11-21,600,18300000,0,0,600,18300000,3663440,
HOSE,IBC,2022-11-21,1000,15800000,400,6320000,600,9480000,25723618,
HOSE,ICT,2022-11-21,500,7225000,0,0,500,7225000,32028428,
HOSE,QCG,2022-11-21,1000,4330000,500,2165000,500,2165000,133127958,
HOSE,CTI,2022-11-21,500,5600000,0,0,500,5600000,30473163,
HOSE,BHN,2022-11-21,300,13200000,0,0,300,13200000,72801450,
HOSE,THG,2022-11-21,700,24220000,400,13840000,300,10380000,9648960,
HOSE,REE,2022-11-21,200,13900000,0,0,200,13900000,9648960,
HOSE,COM,2022-11-21,200,6320000,0,0,200,6320000,6870247,
HOSE,VCA,2022-11-21,100,996000,0,0,100,996000,6152725,
HOSE,VNS,2022-11-21,100,1600000,0,0,100,1600000,19949662,
HOSE,NHT,2022-11-21,100,1455000,0,0,100,1455000,8333363,
HOSE,TMT,2022-11-21,100,840000,0,0,100,840000,17187187,
HOSE,HTL,2022-11-21,100,1535000,0,0,100,1535000,353481,
HOSE,ADG,2022-11-21,100,2950000,0,0,100,2950000,3840301,
HOSE,ACB,2022-11-21,31,638600,0,0,31,638600,3840301,
HOSE,SJF,2022-11-21,0,34102000,0,6936000,0,27166000,38291656,
HOSE,SHA,2022-11-21,0,12950000,0,0,0,12950000,16070038,
HOSE,SFG,2022-11-21,0,7890000,0,0,0,7890000,23130744,
HOSE,SFC,2022-11-21,0,0,0,1900000,0,-1900000,5440089,
HOSE,SGT,2022-11-21,0,0,0,280800,0,-280800,5440089,
HOSE,SMC,2022-11-21,0,0,0,182000,0,-182000,5440089,
HOSE,SII,2022-11-21,0,0,0,20800000,0,-20800000,691605,
HOSE,SFI,2022-11-21,0,3185000,0,0,0,3185000,9081207,
HOSE,BKG,2022-11-21,0,0,0,1038000,0,-1038000,34049011,
HOSE,SMA,2022-11-21,0,1256000,0,20724000,0,-19468000,9958486,
HOSE,SHP,2022-11-21,0,12800000,0,0,0,12800000,44322810,
HOSE,SGR,2022-11-21,0,0,0,3660000,0,-3660000,29396226,
HOSE,PGI,2022-11-21,0,0,0,662500,0,-662500,88087123,
HOSE,PGD,2022-11-21,0,7500000,0,0,0,7500000,2269632,
HOSE,C47,2022-11-21,0,0,0,423950,0,-423950,2269632,
HOSE,PGV,2022-11-21,0,17250000,0,0,0,17250000,561547123,
HOSE,PMG,2022-11-21,0,0,0,16125000,0,-16125000,11037825,
HOSE,PJT,2022-11-21,0,0,0,81000,0,-81000,11037825,
HOSE,PIT,2022-11-21,0,6720000,0,0,0,6720000,7326218,
HOSE,CCI,2022-11-21,0,0,0,87000000,0,-87000000,7326218,
HOSE,CCL,2022-11-21,0,14280000,0,0,0,14280000,26127265,
HOSE,NNC,2022-11-21,0,507200000,0,0,0,507200000,9092947,
HOSE,OPC,2022-11-21,0,0,0,4480000,0,-4480000,9092947,
HOSE,PET,2022-11-21,0,0,0,245850000,0,-245850000,9092947,
HOSE,CAV,2022-11-21,0,0,0,2387500,0,-2387500,28094952,
HOSE,PDN,2022-11-21,0,0,0,13000000,0,-13000000,28094952,
HOSE,BRC,2022-11-21,0,1060000,0,0,0,1060000,6126478,
HOSE,S4A,2022-11-21,0,0,0,192500000,0,-192500000,20649120,
HOSE,RDP,2022-11-21,0,0,0,7404000,0,-7404000,24378472,
HOSE,SAV,2022-11-21,0,0,0,190350000,0,-190350000,1033537,
HOSE,SCD,2022-11-21,0,3590000,0,0,0,3590000,3581190,
HOSE,SC5,2022-11-21,0,0,0,16500000,0,-16500000,6722424,
HOSE,SBV,2022-11-21,0,0,0,12150,0,-12150,23306196,
HOSE,PSH,2022-11-21,0,0,0,0,0,0,23306196,
HOSE,BTT,2022-11-21,0,48060000,0,0,0,48060000,5949557,
HOSE,POM,2022-11-21,0,13104000,0,0,0,13104000,114847776,
HOSE,PTL,2022-11-21,0,0,0,8710000,0,-8710000,114847776,
HOSE,NBB,2022-11-21,0,130560000,0,0,0,130560000,47865829,
HOSE,QBS,2022-11-21,0,0,0,0,0,0,47865829,
HOSE,BTP,2022-11-21,0,4020000,0,0,0,4020000,23950774,
HOSE,UIC,2022-11-21,0,0,0,350000,0,-350000,23950774,
HOSE,TYA,2022-11-21,0,5850000,0,0,0,5850000,3588267,
HOSE,AGM,2022-11-21,0,0,0,6450000,0,-6450000,3588267,
HOSE,VAF,2022-11-21,0,0,0,56700000,0,-56700000,18440186,
HOSE,VFG,2022-11-21,0,0,0,86900,0,-86900,19340633,
HOSE,VDP,2022-11-21,0,0,0,0,0,0,19340633,
HOSE,VCF,2022-11-21,0,43220000,0,0,0,43220000,12847941,
HOSE,TVS,2022-11-21,0,0,0,124020000,0,-124020000,21081622,
HOSE,TSC,2022-11-21,0,0,0,240900,0,-240900,21081622,
HOSE,TRC,2022-11-21,0,0,0,9180000,0,-9180000,14480450,
HOSE,APC,2022-11-21,0,0,0,89100000,0,-89100000,6797258,
HOSE,TTA,2022-11-21,0,0,0,4485000,0,-4485000,76718267,
HOSE,TTF,2022-11-21,0,202230000,0,1569834000,0,-1367604000,202086761,
HOSE,TTE,2022-11-21,0,1130000,0,0,0,1130000,14242930,
HOSE,TTB,2022-11-21,0,0,0,61800,0,-61800,14242930,
HOSE,VPH,2022-11-21,0,812000,0,0,0,812000,45927256,
HOSE,VPD,2022-11-21,0,0,0,6165000,0,-6165000,52174759,
HOSE,VOS,2022-11-21,200,1498000,200,1498000,0,0,66915890,
HOSE,AAM,2022-11-21,0,0,0,13980000,0,-13980000,5929073,
HOSE,YBM,2022-11-21,0,12811000,0,0,0,12811000,6976025,
HOSE,VTB,2022-11-21,0,0,0,11300000,0,-11300000,5316365,
HOSE,VPS,2022-11-21,0,32400000,0,0,0,32400000,11819623,
HOSE,ABR,2022-11-21,0,972000,0,0,0,972000,10248700,
HOSE,VIP,2022-11-21,0,0,0,1237872000,0,-1237872000,31950096,
HOSE,VID,2022-11-21,0,0,0,602000,0,-602000,20233544,
HOSE,ACC,2022-11-21,0,0,0,5800000,0,-5800000,42689787,
HOSE,VMD,2022-11-21,0,51900000,0,0,0,51900000,7345150,
HOSE,VNG,2022-11-21,0,68220000,0,1516000,0,66704000,47190164,
HOSE,ABS,2022-11-21,0,0,0,0,0,0,47190164,
HOSE,ABT,2022-11-21,0,3300000,0,26400000,0,-23100000,6806210,
HOSE,SVI,2022-11-21,0,14380000,0,0,0,14380000,653244,
HOSE,SVD,2022-11-21,0,8370000,0,0,0,8370000,12545700,
HOSE,SVC,2022-11-21,0,0,0,11220000,0,-11220000,15705374,
HOSE,SVT,2022-11-21,0,54000000,0,0,0,54000000,7319570,
HOSE,TCB,2022-11-21,0,227000000,0,0,0,227000000,7319570,
HOSE,TBC,2022-11-21,0,0,0,41250000,0,-41250000,30613186,
HOSE,SZL,2022-11-21,0,0,0,46300,0,-46300,30613186,
HOSE,BBC,2022-11-21,0,27720000,0,0,0,27720000,9223079,
HOSE,SRF,2022-11-21,0,0,0,5050000,0,-5050000,18932307,
HOSE,SRC,2022-11-21,0,0,0,10100000,0,-10100000,13725555,
HOSE,SPM,2022-11-21,0,0,0,2700000,0,-2700000,6588990,
HOSE,SSB,2022-11-21,0,0,0,3000000,0,-3000000,95403186,
HOSE,STG,2022-11-21,0,0,0,8170000,0,-8170000,48078780,
HOSE,ST8,2022-11-21,0,0,0,0,0,0,48078780,
HOSE,SSC,2022-11-21,0,3580000,0,0,0,3580000,7171777,
HOSE,TNA,2022-11-21,0,7440000,0,0,0,7440000,22545851,
HOSE,TN1,2022-11-21,0,0,0,1890000,0,-1890000,21533302,
HOSE,TMS,2022-11-21,0,0,0,41340000,0,-41340000,5585560,
HOSE,TNC,2022-11-21,0,0,0,15900000,0,-15900000,9324510,
HOSE,TPC,2022-11-21,0,10880000,0,544000,0,10336000,11356790,
HOSE,APG,2022-11-21,0,53725000,0,3070000,0,50655000,143821006,
HOSE,TNI,2022-11-21,0,5380000,0,0,0,5380000,25565990,
HOSE,ASG,2022-11-21,0,2520000,0,0,0,2520000,22052039,
HOSE,TDP,2022-11-21,0,0,0,141000000,0,-141000000,30684004,
HOSE,TDG,2022-11-21,0,0,0,1190000,0,-1190000,30684004,
HOSE,ASP,2022-11-21,0,0,0,2750000,0,-2750000,1082,
HOSE,TDW,2022-11-21,0,4325000,0,0,0,4325000,4016420,
HOSE,TIX,2022-11-21,0,0,0,61400000,0,-61400000,4016420,
HOSE,THI,2022-11-21,0,0,0,2300000,0,-2300000,23887340,
HOSE,TGG,2022-11-21,0,0,0,14518400,0,-14518400,23887340,
HOSE,CTF,2022-11-21,0,0,0,429300000,0,-429300000,37181353,
HOSE,HMC,2022-11-21,0,0,0,62578000,0,-62578000,37181353,
HOSE,HOT,2022-11-21,0,60300000,0,60300000,0,0,37181353,
HOSE,HRC,2022-11-21,0,0,0,5700000,0,-5700000,14608815,
HOSE,HPX,2022-11-21,0,22500000,0,0,0,22500000,112780462,
HOSE,HII,2022-11-21,0,2145000,0,0,0,2145000,36215385,
HOSE,CVT,2022-11-21,0,0,0,161000,0,-161000,18171580,
HOSE,GTA,2022-11-21,0,0,0,116000,0,-116000,5036715,
HOSE,HAS,2022-11-21,0,837000,0,0,0,837000,2584159,
HOSE,HHP,2022-11-21,0,900000,0,0,0,900000,13941007,
HOSE,HCD,2022-11-21,0,0,0,10185000,0,-10185000,15450682,
HOSE,HTI,2022-11-21,0,171200000,0,0,0,171200000,6900701,
HOSE,ILB,2022-11-21,0,551475000,0,0,0,551475000,11635900,
HOSE,HVX,2022-11-21,0,2169000,0,0,0,2169000,19244101,
HOSE,ITC,2022-11-21,0,0,0,1150000,0,-1150000,19244101,
HOSE,KHP,2022-11-21,0,0,0,184100000,0,-184100000,28405439,
HOSE,CRC,2022-11-21,0,530000,0,0,0,530000,14902730,
HOSE,CSM,2022-11-21,0,0,0,42000000,0,-42000000,51054689,
HOSE,HU1,2022-11-21,0,1050000,0,0,0,1050000,4651370,
HOSE,HTV,2022-11-21,0,9920000,0,0,0,9920000,4927486,
HOSE,HU3,2022-11-21,0,719000,0,0,0,719000,4430782,
HOSE,HVH,2022-11-21,0,5010000,0,0,0,5010000,17900752,
HOSE,HUB,2022-11-21,0,0,0,237300000,0,-237300000,17900752,
HOSE,EVG,2022-11-21,0,0,0,8932000,0,-8932000,105276447,
HOSE,EMC,2022-11-21,0,0,0,0,0,0,105276447,
HOSE,FCM,2022-11-21,0,191690400,0,0,0,191690400,20717399,
HOSE,FIT,2022-11-21,0,0,0,234080,0,-234080,20717399,
HOSE,FDC,2022-11-21,0,0,0,7170600,0,-7170600,19308250,
HOSE,DXV,2022-11-21,0,0,0,5460000,0,-5460000,4789650,
HOSE,DRL,2022-11-21,0,0,0,1334000,0,-1334000,4789650,
HOSE,DHM,2022-11-21,0,0,0,2967000,0,-2967000,4789650,
HOSE,DTA,2022-11-21,0,5490000,0,0,0,5490000,8825251,
HOSE,DTT,2022-11-21,0,0,0,0,0,0,3975195,
HOSE,DTL,2022-11-21,0,0,0,683800,0,-683800,30102450,
HOSE,DCL,2022-11-21,0,0,0,89964000,0,-89964000,30102450,
HOSE,GAB,2022-11-21,0,0,0,0,0,0,4425748,
HOSE,DAT,2022-11-21,0,0,0,1530000,0,-1530000,4425748,
HOSE,DAH,2022-11-21,0,0,0,173500,0,-173500,4425748,
HOSE,GSP,2022-11-21,0,0,0,0,0,0,4425748,
HOSE,GMH,2022-11-21,0,6400000,0,0,0,6400000,8242700,
HOSE,DBD,2022-11-21,0,73200000,0,0,0,73200000,69274800,
HOSE,FUCTVGF4,2022-11-21,0,0,0,0,0,0,9829400,
HOSE,FUCTVGF3,2022-11-21,0,0,0,0,0,0,9751392,
HOSE,FUEIP100,2022-11-21,0,9772000,0,0,0,9772000,5655100,
HOSE,DBT,2022-11-21,0,0,0,2400000,0,-2400000,5655100,
HOSE,DC4,2022-11-21,0,0,0,444000,0,-444000,26196671,
HOSE,LGL,2022-11-21,0,32100000,0,0,0,32100000,24292973,
HOSE,MWG,2022-11-21,100000,4065000000,100000,4065000000,0,0,24292973,
HOSE,CMV,2022-11-21,0,0,0,1420000,0,-1420000,24292973,
HOSE,KPF,2022-11-21,0,5600000,0,0,0,5600000,27950529,
HOSE,MDG,2022-11-21,0,21720000,0,0,0,21720000,5334225,
HOSE,MHC,2022-11-21,0,1640000,0,0,0,1640000,19362894,
HOSE,LGC,2022-11-21,0,0,0,44010000,0,-44010000,7738849,
HOSE,LEC,2022-11-21,0,0,0,15572000,0,-15572000,12785977,
HOSE,CKG,2022-11-21,0,0,0,379320000,0,-379320000,12785977,
HOSE,L10,2022-11-21,0,0,0,0,0,0,4723147,
HOSE,LAF,2022-11-21,0,0,0,0,0,0,6935865,
HOSE,CLW,2022-11-21,0,37000000,0,0,0,37000000,5737010,
HOSE,LSS,2022-11-21,0,0,0,3330000,0,-3330000,5737010,
HOSE,MCG,2022-11-21,0,546000,0,0,0,546000,28069591,
HOSE,CLL,2022-11-21,0,12275000,0,0,0,12275000,14269539,
HOSE,KMR,2022-11-21,0,139551000,0,2570000,0,136981000,21260504,
HOSE,NAV,2022-11-21,0,18400000,0,0,0,18400000,3841253,
HOSE,LM8,2022-11-21,0,0,0,12870000,0,-12870000,3841253,
HOSE,CIG,2022-11-21,0,0,0,208500000,0,-208500000,15443761,
HOSE,MCP,2022-11-21,0,0,0,359100,0,-359100,7361080,
HOSE,TLD,2022-11-21,0,0,1,3200,-1,-3200,36151355,
HOSE,DHG,2022-11-21,0,0,100,8200000,-100,-8200000,59849687,
HOSE,TCD,2022-11-21,0,0,200,996000,-200,-996000,118429181,
HOSE,FUEKIVFS,2022-11-21,25000,188750000,25400,191770000,-400,-3020000,802700,
HOSE,OCB,2022-11-21,16100,231035000,16500,236775000,-400,-5740000,7362946,
HOSE,ACG,2022-11-21,100,3600000,500,18000000,-400,-14400000,15524642,
HOSE,DRC,2022-11-21,3900,74100000,4300,81700000,-400,-7600000,48960341,
HOSE,GMC,2022-11-21,500,5700000,1000,11400000,-500,-5700000,13418778,
HOSE,TNT,2022-11-21,0,0,500,1555000,-500,-1555000,24960840,
HOSE,HSL,2022-11-21,0,0,500,1820000,-500,-1820000,16590740,
HOSE,ELC,2022-11-21,4000,31000000,4500,34875000,-500,-3875000,22728756,
HOSE,SBA,2022-11-21,0,0,500,12300000,-500,-12300000,29426152,
HOSE,CRE,2022-11-21,0,0,500,5250000,-500,-5250000,96371625,
HOSE,PNC,2022-11-21,0,0,800,6560000,-800,-6560000,5322491,
HOSE,VSI,2022-11-21,0,0,800,11200000,-800,-11200000,6375240,
HOSE,NCT,2022-11-21,0,0,900,76230000,-900,-76230000,4625364,
HOSE,AGG,2022-11-21,0,0,900,30150000,-900,-30150000,50337050,
HOSE,TEG,2022-11-21,0,0,965,6619900,-965,-6619900,32069783,
HOSE,DPR,2022-11-21,300,13365000,1300,57915000,-1000,-44550000,20364013,
HOSE,CTR,2022-11-21,7000,294700000,8000,336800000,-1000,-42100000,44876478,
HOSE,PNJ,2022-11-21,20900,2133890000,22000,2246200000,-1100,-112310000,44876478,
HOSE,PHC,2022-11-21,0,0,1100,6050000,-1100,-6050000,24660457,
HOSE,SCS,2022-11-21,1800,126360000,3000,210600000,-1200,-84240000,1168227,
HOSE,DQC,2022-11-21,0,0,1300,18525000,-1300,-18525000,16523889,
HOSE,FUCVREIT,2022-11-21,600,3864000,1900,12236000,-1300,-8372000,2347610,
HOSE,PTC,2022-11-21,0,0,1400,6538000,-1400,-6538000,15811732,
HOSE,TDM,2022-11-21,500,15300000,1900,58140000,-1400,-42840000,42725521,
HOSE,TIP,2022-11-21,1200,19740000,3000,49350000,-1800,-29610000,21273557,
HOSE,DPG,2022-11-21,0,0,2000,44700000,-2000,-44700000,30177175,
HOSE,SJS,2022-11-21,0,0,2300,93840000,-2300,-93840000,56442548,
HOSE,NHA,2022-11-21,0,0,2400,24120000,-2400,-24120000,20447091,
HOSE,DAG,2022-11-21,0,0,2600,9230000,-2600,-9230000,29018026,
HOSE,FUEDCMID,2022-11-21,0,0,3200,22784000,-3200,-22784000,1144475,
HOSE,GEG,2022-11-21,503,5633600,3800,42560000,-3297,-36926400,47586958,
HOSE,HID,2022-11-21,0,0,4000,10240000,-4000,-10240000,37079892,
HOSE,DSN,2022-11-21,400,18940000,4400,208340000,-4000,-189400000,3262831,
HOSE,DVP,2022-11-21,0,0,4400,187000000,-4400,-187000000,14680619,
HOSE,NHH,2022-11-21,100,1320000,5000,66000000,-4900,-64680000,72463158,
HOSE,PLP,2022-11-21,0,0,4900,20482000,-4900,-20482000,33354934,
HOSE,IMP,2022-11-21,0,0,5002,263105200,-5002,-263105200,16785747,
HOSE,HAR,2022-11-21,0,0,5200,17004000,-5200,-17004000,49438185,
HOSE,OGC,2022-11-21,500,3600000,6500,46800000,-6000,-43200000,146519858,
HOSE,TLG,2022-11-21,0,0,6400,275840000,-6400,-275840000,62377813,
HOSE,FUEKIV30,2022-11-21,25100,158130000,31600,199080000,-6500,-40950000,8396100,
HOSE,FRT,2022-11-21,21750,1363725000,28700,1799490000,-6950,-435765000,29104657,
HOSE,DRH,2022-11-21,0,0,7404,24433200,-7404,-24433200,60565759,
HOSE,HT1,2022-11-21,17900,154656000,26200,226368000,-8300,-71712000,179422770,
HOSE,CSV,2022-11-21,17300,482670000,25700,717030000,-8400,-234360000,20131846,
HOSE,ORS,2022-11-21,7600,63004000,16700,138443000,-9100,-75439000,95268867,
HOSE,VDS,2022-11-21,4630,33197100,13900,99663000,-9270,-66465900,206722214,
HOSE,VSH,2022-11-21,3000,86550000,12300,354855000,-9300,-268305000,88446947,
HOSE,CNG,2022-11-21,800,17360000,10200,221340000,-9400,-203980000,11610454,
HOSE,CTD,2022-11-21,15200,433200000,25854,736839000,-10654,-303639000,214669,
HOSE,GAS,2022-11-21,10200,1135260000,21360,2377368000,-11160,-1242108000,880389051,
HOSE,KHG,2022-11-21,27600,125856000,38800,176928000,-11200,-51072000,213807865,
HOSE,BSI,2022-11-21,400,5920000,12200,180560000,-11800,-174640000,117751129,
HOSE,PHR,2022-11-21,1200,44160000,13304,489587200,-12104,-445427200,50877308,
HOSE,LIX,2022-11-21,200,7840000,13000,509600000,-12800,-501760000,13211239,
HOSE,LPB,2022-11-21,0,0,13000,126750000,-13000,-126750000,13211239,
HOSE,GIL,2022-11-21,0,0,15100,328425000,-15100,-328425000,31988603,
HOSE,AGR,2022-11-21,9400,64202000,25400,173482000,-16000,-109280000,103158869,
HOSE,HDC,2022-11-21,0,0,17100,568575000,-17100,-568575000,52029944,
HOSE,CHP,2022-11-21,0,0,17808,398899200,-17808,-398899200,52029944,
HOSE,CMX,2022-11-21,2800,18536000,25000,165500000,-22200,-146964000,40914966,
HOSE,ACL,2022-11-21,0,0,23000,240350000,-23000,-240350000,18242660,
HOSE,E1VFVN30,2022-11-21,1158600,18873594000,1182250,19258852500,-23650,-385258500,31215020,
HOSE,DCM,2022-11-21,518100,13185645000,542800,13814260000,-24700,-628615000,200403069,
HOSE,BMP,2022-11-21,0,0,25000,1347500000,-25000,-1347500000,11740834,
HOSE,ITA,2022-11-21,99900,324675000,125500,407875000,-25600,-83200000,395845852,
HOSE,HBC,2022-11-21,25900,209531000,52400,423916000,-26500,-214385000,90383529,
HOSE,AAT,2022-11-21,700,3430000,28800,141120000,-28100,-137690000,31726550,
HOSE,NKG,2022-11-21,469400,4534404000,497800,4808748000,-28400,-274344000,102360684,
HOSE,MSH,2022-11-21,400,14720000,31200,1148160000,-30800,-1133440000,32808324,
HOSE,TDC,2022-11-21,1300,11050000,34100,289850000,-32800,-278800000,48302350,
HOSE,TCH,2022-11-21,192800,1434432000,226200,1682928000,-33400,-248496000,323741559,
HOSE,CTS,2022-11-21,3000,26640000,38100,338328000,-35100,-311688000,70078060,
HOSE,VPG,2022-11-21,0,0,40100,575435000,-40100,-575435000,38905733,
HOSE,PAN,2022-11-21,10500,150675000,54307,779305450,-43807,-628630450,82715186,
HOSE,BMI,2022-11-21,2400,45120000,51700,971960000,-49300,-926840000,18373437,
HOSE,NTL,2022-11-21,4000,67200000,53500,898800000,-49500,-831600000,22427995,
HOSE,ASM,2022-11-21,21900,162060000,81900,606060000,-60000,-444000000,156968059,
HOSE,BCG,2022-11-21,71300,407123000,134200,766282000,-62900,-359159000,250603375,
HOSE,BAF,2022-11-21,24700,410020000,87640,1454824000,-62940,-1044804000,70608544,
HOSE,HHV,2022-11-21,20300,168490000,88200,732060000,-67900,-563570000,124347255,
HOSE,PTB,2022-11-21,89700,3309930000,158580,5851602000,-68880,-2541672000,5530268,
HOSE,VGC,2022-11-21,6400,193920000,76400,2314920000,-70000,-2121000000,193936647,
HOSE,VSC,2022-11-21,1400,44100000,79550,2505825000,-78150,-2461725000,53744565,
HOSE,CII,2022-11-21,49100,630935000,127640,1640174000,-78540,-1009239000,117664131,
HOSE,VTO,2022-11-21,23000,153870000,119500,799455000,-96500,-645585000,38157825,
HOSE,DPM,2022-11-21,98300,3538800000,203600,7329600000,-105300,-3790800000,121080605,
HOSE,FCN,2022-11-21,1300,9867000,111000,842490000,-109700,-832623000,27594542,
HOSE,IDI,2022-11-21,15800,136038000,132500,1140825000,-116700,-1004787000,108962420,
HOSE,KDC,2022-11-21,17500,1032500000,135000,7965000000,-117500,-6932500000,67511775,
HOSE,CTG,2022-11-21,1040400,25073640000,1169750,28190975000,-129350,-3117335000,131916401,
HOSE,HAX,2022-11-21,1900,26980000,135800,1928360000,-133900,-1901380000,10669546,
HOSE,VCB,2022-11-21,694800,52110000000,832803,62460225000,-138003,-10350225000,302148608,
HOSE,APH,2022-11-21,400,2900000,144800,1049800000,-144400,-1046900000,172675333,
HOSE,LDG,2022-11-21,4500,18900000,149300,627060000,-144800,-608160000,117805178,
HOSE,IJC,2022-11-21,0,0,147600,1616220000,-147600,-1616220000,92312267,
HOSE,LCG,2022-11-21,8400,48468000,160500,926085000,-152100,-877617000,91092759,
HOSE,HSG,2022-11-21,521300,5009693000,678302,6518482220,-157002,-1508789220,256491839,
HOSE,DGW,2022-11-21,68000,2720000000,239596,9583840000,-171596,-6863840000,37200728,
HOSE,DBC,2022-11-21,59100,735795000,258500,3218325000,-199400,-2482530000,106706831,
HOSE,MIG,2022-11-21,134900,1881855000,335700,4683015000,-200800,-2801160000,148896650,
HOSE,SCR,2022-11-21,20800,104000000,242800,1214000000,-222000,-1110000000,175215966,
HOSE,VIX,2022-11-21,163600,1112480000,408100,2775080000,-244500,-1662600000,555675501,
HOSE,HDG,2022-11-21,325400,8850880000,586112,15942246400,-260712,-7091366400,77086245,
HOSE,PC1,2022-11-21,77100,1268295000,426351,7013473950,-349251,-5745178950,103973571,
HOSE,HCM,2022-11-21,108400,2005400000,458961,8490778500,-350561,-6485378500,37925071,
HOSE,DXS,2022-11-21,75500,405435000,477600,2564712000,-402100,-2159277000,132307439,
HOSE,HAG,2022-11-21,40700,315425000,519600,4026900000,-478900,-3711475000,433637279,
HOSE,FTS,2022-11-21,260,4251000,543700,8889495000,-543440,-8885244000,144868374,
HOSE,VRE,2022-11-21,715000,18804500000,1261503,33177528900,-546503,-14373028900,394749884,
HOSE,VHM,2022-11-21,1016545,47726787750,1584954,74413590300,-568409,-26686802550,1161344013,
HOSE,DIG,2022-11-21,181400,2303780000,1034500,13138150000,-853100,-10834370000,273677459,
HOSE,FUEMAV30,2022-11-21,43600,490500000,1409400,15855750000,-1365800,-15365250000,5450260,
HOSE,STB,2022-11-21,926000,15464200000,2955200,49351840000,-2029200,-33887640000,131381576,
HOSE,DGC,2022-11-21,178100,9100910000,3068600,156805460000,-2890500,-147704550000,122457453,
HOSE,DXG,2022-11-21,299100,3140550000,5062700,53158350000,-4763600,-50017800000,138869174,
HOSE,SSI,2022-11-22,6574500,107493075000,2487818,40675824300,4086682,66817250700,928718143,
HOSE,MBB,2022-11-22,7258864,114690051200,3300149,52142354200,3958715,62547697000,928718143,
HOSE,POW,2022-11-22,2522200,26104770000,161700,1673595000,2360500,24431175000,1050565307,
HOSE,FUEVFVND,2022-11-22,4880100,99310035000,2574800,52397180000,2305300,46912855000,15079348,
HOSE,HPG,2022-11-22,7622330,112810484000,5416500,80164200000,2205830,32646284000,1693977805,
HOSE,BID,2022-11-22,1174800,42821460000,99700,3634065000,1075100,39187395000,654668529,
HOSE,VNM,2022-11-22,1458600,115958700000,520884,41410278000,937716,74548422000,924763573,
HOSE,PVT,2022-11-22,750700,12611760000,21100,354480000,729600,12257280000,102416751,
HOSE,PVD,2022-11-22,538400,7645280000,40705,578011000,497695,7067269000,180119853,
HOSE,VCI,2022-11-22,699212,14124082400,225920,4563584000,473292,9560498400,356683382,
HOSE,SBT,2022-11-22,472530,5197830000,13702,150722000,458828,5047108000,575142075,
HOSE,GMD,2022-11-22,442900,18933975000,1900,81225000,441000,18852750000,1834556,
HOSE,DCM,2022-11-22,1001600,25791200000,594300,15303225000,407300,10487975000,199450369,
HOSE,VIX,2022-11-22,436200,2987970000,40300,276055000,395900,2711915000,555242101,
HOSE,KDH,2022-11-22,816000,18319200000,424370,9527106500,391630,8792093500,105825340,
HOSE,VRE,2022-11-22,1297500,33929625000,909903,23793963450,387597,10135661550,394224209,
HOSE,VHM,2022-11-22,952900,43166370000,629600,28520880000,323300,14645490000,1160456023,
HOSE,TCH,2022-11-22,302900,2411084000,26300,209348000,276600,2201736000,323455459,
HOSE,PDR,2022-11-22,275670,4396936500,95,1515250,275575,4395421250,308572798,
HOSE,VPB,2022-11-22,266210,4126255000,2400,37200000,263810,4089055000,51,
HOSE,LHG,2022-11-22,267000,5073000000,4100,77900000,262900,4995100000,17864966,
HOSE,MSN,2022-11-22,764990,70226082000,526100,48295980000,238890,21930102000,272389608,
HOSE,CII,2022-11-22,217300,2781440000,9300,119040000,208000,2662400000,117616631,
HOSE,NT2,2022-11-22,223200,5356800000,23800,571200000,199400,4785600000,95823465,
HOSE,CTR,2022-11-22,164200,7003130000,1500,63975000,162700,6939155000,44715278,
HOSE,KSB,2022-11-22,179600,2505420000,18900,263655000,160700,2241765000,31910315,
HOSE,FRT,2022-11-22,250500,15881700000,92000,5832800000,158500,10048900000,28856859,
HOSE,PHR,2022-11-22,138600,5197500000,1100,41250000,137500,5156250000,50761208,
HOSE,TLG,2022-11-22,142100,6252400000,9500,418000000,132600,5834400000,62255213,
HOSE,HDB,2022-11-22,1340175,19633563750,1209059,17712714350,131116,1920849400,2,
HOSE,VIC,2022-11-22,642290,39179690000,516666,31516626000,125624,7663064000,1386693191,
HOSE,BVH,2022-11-22,139500,6716925000,15200,731880000,124300,5985045000,167088915,
HOSE,VCG,2022-11-22,158400,2217600000,35100,491400000,123300,1726200000,222171379,
HOSE,DGW,2022-11-22,139900,5274230000,30500,1149850000,109400,4124380000,37098148,
HOSE,ASM,2022-11-22,113200,871640000,6000,46200000,107200,825440000,157059859,
HOSE,TNH,2022-11-22,117100,3688650000,10600,333900000,106500,3354750000,5131769,
HOSE,VGC,2022-11-22,111900,3379380000,14705,444091000,97195,2935289000,193920447,
HOSE,DPG,2022-11-22,103800,2366640000,6700,152760000,97100,2213880000,30094575,
HOSE,PAN,2022-11-22,96100,1345400000,2000,28000000,94100,1317400000,82664386,
HOSE,CSV,2022-11-22,91600,2628920000,1900,54530000,89700,2574390000,20058446,
HOSE,KPF,2022-11-22,80000,741600000,0,0,80000,741600000,27870529,
HOSE,BWE,2022-11-22,79200,3168000000,4900,196000000,74300,2972000000,60151104,
HOSE,HHS,2022-11-22,85300,311345000,15200,55480000,70100,255865000,154549294,
HOSE,PLX,2022-11-22,131100,3434820000,63900,1674180000,67200,1760640000,34368899,
HOSE,VJC,2022-11-22,93907,9212276700,31968,3136060800,61939,6076215900,73084672,
HOSE,DXS,2022-11-22,96800,555632000,36900,211806000,59900,343826000,133352639,
HOSE,KHG,2022-11-22,66200,317098000,8500,40715000,57700,276383000,213824065,
HOSE,STK,2022-11-22,50000,1290000000,0,0,50000,1290000000,73593765,
HOSE,FUEVN100,2022-11-22,81700,974681000,33600,400848000,48100,573833000,12978970,
HOSE,AAA,2022-11-22,58323,405928080,12575,87522000,45748,318406080,372499446,
HOSE,DBC,2022-11-22,178700,2206945000,134000,1654900000,44700,552045000,106736431,
HOSE,ITA,2022-11-22,55100,181830000,10906,35989800,44194,145840200,395827252,
HOSE,CMG,2022-11-22,58400,2099480000,15500,557225000,42900,1542255000,11785594,
HOSE,EIB,2022-11-22,124800,2408640000,82000,1582600000,42800,826040000,78258389,
HOSE,ANV,2022-11-22,127800,2313180000,86300,1562030000,41500,751150000,57408244,
HOSE,BFC,2022-11-22,62700,990660000,22800,360240000,39900,630420000,25816466,
HOSE,SMB,2022-11-22,36900,1531350000,1300,53950000,35600,1477400000,10331945,
HOSE,SAB,2022-11-22,66400,12031680000,34100,6178920000,32300,5852760000,239433611,
HOSE,TV2,2022-11-22,32200,656880000,0,0,32200,656880000,23715,
HOSE,SCS,2022-11-22,31400,2260800000,400,28800000,31000,2232000000,1136827,
HOSE,TPB,2022-11-22,31500,650475000,835,17242750,30665,633232250,23,
HOSE,HDC,2022-11-22,30800,1001000000,200,6500000,30600,994500000,52000644,
HOSE,HNG,2022-11-22,98200,412440000,70400,295680000,27800,116760000,534130033,
HOSE,DRC,2022-11-22,27500,521125000,1300,24635000,26200,496490000,48975141,
HOSE,FUEMAV30,2022-11-22,97900,1100396000,72300,812652000,25600,287744000,5413160,
HOSE,EVE,2022-11-22,23700,314025000,100,1325000,23600,312700000,11783944,
HOSE,AAT,2022-11-22,38600,200720000,15100,78520000,23500,122200000,31687950,
HOSE,HDG,2022-11-22,137400,3668580000,114200,3049140000,23200,619440000,77393360,
HOSE,FUESSVFL,2022-11-22,40500,501795000,17600,218064000,22900,283731000,9223000,
HOSE,VHC,2022-11-22,223850,14908410000,201000,13386600000,22850,1521810000,128024774,
HOSE,FMC,2022-11-22,33000,1047750000,10800,342900000,22200,704850000,12093424,
HOSE,FUESSV30,2022-11-22,26600,309890000,5600,65240000,21000,244650000,3337270,
HOSE,BMP,2022-11-22,83800,4592240000,63200,3463360000,20600,1128880000,11664134,
HOSE,ADS,2022-11-22,21500,204250000,1400,13300000,20100,190950000,21388498,
HOSE,VNS,2022-11-22,20000,320000000,900,14400000,19100,305600000,19929662,
HOSE,KOS,2022-11-22,19000,684000000,0,0,19000,684000000,105967843,
HOSE,ORS,2022-11-22,36200,306976000,18100,153488000,18100,153488000,95234567,
HOSE,OCB,2022-11-22,55700,810435000,38200,555810000,17500,254625000,7347246,
HOSE,CTD,2022-11-22,23500,695600000,7000,207200000,16500,488400000,216769,
HOSE,BCG,2022-11-22,48700,288304000,32300,191216000,16400,97088000,250700575,
HOSE,DHA,2022-11-22,16200,452790000,600,16770000,15600,436020000,5115584,
HOSE,CTF,2022-11-22,15300,400860000,0,0,15300,400860000,37167153,
HOSE,TVB,2022-11-22,16500,64350000,1200,4680000,15300,59670000,30793188,
HOSE,TCM,2022-11-22,14800,664520000,0,0,14800,664520000,1996770,
HOSE,VNE,2022-11-22,14800,136160000,400,3680000,14400,132480000,38928941,
HOSE,MIG,2022-11-22,28000,392000000,13600,190400000,14400,201600000,148894650,
HOSE,DHC,2022-11-22,16500,559350000,2300,77970000,14200,481380000,12058299,
HOSE,EVF,2022-11-22,13800,91770000,0,0,13800,91770000,175202624,
HOSE,GEG,2022-11-22,13500,151875000,0,0,13500,151875000,47594558,
HOSE,BCM,2022-11-22,46200,3465000000,33800,2535000000,12400,930000000,476217480,
HOSE,CTI,2022-11-22,16100,185150000,5000,57500000,11100,127650000,30457063,
HOSE,TCD,2022-11-22,10800,57348000,0,0,10800,57348000,118418381,
HOSE,TCL,2022-11-22,14440,409374000,3700,104895000,10740,304479000,13335641,
HOSE,NVT,2022-11-22,10500,74025000,0,0,10500,74025000,45137980,
HOSE,CDC,2022-11-22,10100,179780000,0,0,10100,179780000,10665313,
HOSE,AST,2022-11-22,10000,518000000,100,5180000,9900,512820000,2030882,
HOSE,HVN,2022-11-22,33633,315477540,24300,227934000,9333,87543540,532947804,
HOSE,NBB,2022-11-22,9300,120900000,0,0,9300,120900000,47856529,
HOSE,BIC,2022-11-22,20800,557440000,12100,324280000,8700,233160000,2564644,
HOSE,CNG,2022-11-22,7800,170820000,0,0,7800,170820000,11613054,
HOSE,TCT,2022-11-22,7700,246400000,0,0,7700,246400000,3655740,
HOSE,DBD,2022-11-22,7300,266450000,0,0,7300,266450000,69267500,
HOSE,HTN,2022-11-22,10300,171495000,3100,51615000,7200,119880000,42957827,
HOSE,HT1,2022-11-22,10400,93392000,4200,37716000,6200,55676000,179417070,
HOSE,FUEKIV30,2022-11-22,31800,197160000,25900,160580000,5900,36580000,8397400,
HOSE,NSC,2022-11-22,5700,393300000,101,6969000,5599,386331000,7108990,
HOSE,PGC,2022-11-22,5000,87500000,0,0,5000,87500000,26457065,
HOSE,TRA,2022-11-22,5000,474500000,0,0,5000,474500000,1268141,
HOSE,HII,2022-11-22,5000,21700000,500,2170000,4500,19530000,36210385,
HOSE,TTA,2022-11-22,5200,45760000,1000,8800000,4200,36960000,76715867,
HOSE,SJD,2022-11-22,4000,58000000,0,0,4000,58000000,23450484,
HOSE,KDC,2022-11-22,5000,305000000,1000,61000000,4000,244000000,67699397,
HOSE,PNJ,2022-11-22,390900,40262700000,387001,39861103000,3899,401597000,67699397,
HOSE,VPH,2022-11-22,3800,16682000,0,0,3800,16682000,45923456,
HOSE,SKG,2022-11-22,5300,71020000,2800,37520000,2500,33500000,7780115,
HOSE,MSB,2022-11-22,5000,59750000,2500,29875000,2500,29875000,3558,
HOSE,SGN,2022-11-22,2500,132500000,0,0,2500,132500000,9245084,
HOSE,QCG,2022-11-22,3000,13080000,500,2180000,2500,10900000,133125458,
HOSE,MSH,2022-11-22,3200,118400000,900,33300000,2300,85100000,32836524,
HOSE,VPI,2022-11-22,2300,119830000,0,0,2300,119830000,116267147,
HOSE,TEG,2022-11-22,2500,17625000,200,1410000,2300,16215000,32067483,
HOSE,DPR,2022-11-22,3610,162450000,1600,72000000,2010,90450000,20402103,
HOSE,VDS,2022-11-22,11500,81305000,9600,67872000,1900,13433000,206712914,
HOSE,TVT,2022-11-22,2000,48800000,100,2440000,1900,46360000,9449810,
HOSE,FIR,2022-11-22,2600,122200000,700,32900000,1900,89300000,21845423,
HOSE,D2D,2022-11-22,2000,40400000,107,2161400,1893,38238600,14020369,
HOSE,HAP,2022-11-22,1800,8532000,0,0,1800,8532000,51512016,
HOSE,VIB,2022-11-22,1800,32760000,81,1474200,1719,31285800,51512016,
HOSE,VNG,2022-11-22,1500,11895000,0,0,1500,11895000,47188664,
HOSE,TVS,2022-11-22,1500,33975000,0,0,1500,33975000,21080122,
HOSE,RAL,2022-11-22,2300,170200000,800,59200000,1500,111000000,10869390,
HOSE,SHI,2022-11-22,3100,44640000,1900,27360000,1200,17280000,79283085,
HOSE,SVT,2022-11-22,1000,10600000,0,0,1000,10600000,7318570,
HOSE,FUESSV50,2022-11-22,1000,11780000,0,0,1000,11780000,7042542,
HOSE,AGR,2022-11-22,10500,73185000,9600,66912000,900,6273000,103156569,
HOSE,TDM,2022-11-22,1200,36840000,400,12280000,800,24560000,42724521,
HOSE,DXV,2022-11-22,600,2610000,0,0,600,2610000,4789050,
HOSE,LIX,2022-11-22,548,21700800,0,0,548,21700800,13210691,
HOSE,ASP,2022-11-22,300,1833000,0,0,300,1833000,782,
HOSE,DHG,2022-11-22,300,24810000,4,330800,296,24479200,59849387,
HOSE,DSN,2022-11-22,200,9360000,0,0,200,9360000,3263831,
HOSE,GDT,2022-11-22,200,6290000,0,0,200,6290000,5138975,
HOSE,REE,2022-11-22,200,14000000,0,0,200,14000000,5138975,
HOSE,KMR,2022-11-22,100,277000,0,0,100,277000,21261404,
HOSE,ITD,2022-11-22,100,1190000,0,0,100,1190000,10123909,
HOSE,LBM,2022-11-22,100,4210000,0,0,100,4210000,7333802,
HOSE,ABT,2022-11-22,100,3070000,0,0,100,3070000,6806110,
HOSE,NHH,2022-11-22,100,1340000,0,0,100,1340000,72463058,
HOSE,YBM,2022-11-22,100,570000,0,0,100,570000,6975925,
HOSE,FPT,2022-11-22,7,493500,0,0,7,493500,6975925,
HOSE,QBS,2022-11-22,0,0,0,0,0,0,6975925,
HOSE,SAV,2022-11-22,0,0,0,190350000,0,-190350000,1033537,
HOSE,APC,2022-11-22,0,0,0,89100000,0,-89100000,6797258,
HOSE,SBV,2022-11-22,0,0,0,12150,0,-12150,23306196,
HOSE,SBA,2022-11-22,0,0,0,12300000,0,-12300000,29426152,
HOSE,SCD,2022-11-22,0,3590000,0,0,0,3590000,3581190,
HOSE,RDP,2022-11-22,0,0,0,7404000,0,-7404000,24378472,
HOSE,APG,2022-11-22,0,53725000,0,3070000,0,50655000,143821006,
HOSE,S4A,2022-11-22,0,0,0,192500000,0,-192500000,20649120,
HOSE,BKG,2022-11-22,0,0,0,1038000,0,-1038000,34049011,
HOSE,PDN,2022-11-22,0,0,0,13000000,0,-13000000,34049011,
HOSE,PAC,2022-11-22,0,33990000,0,0,0,33990000,16825569,
HOSE,PGD,2022-11-22,0,7500000,0,0,0,7500000,2269632,
HOSE,BHN,2022-11-22,0,13200000,0,0,0,13200000,72801450,
HOSE,PET,2022-11-22,0,0,0,245850000,0,-245850000,72801450,
HOSE,TYA,2022-11-22,0,5850000,0,0,0,5850000,3588267,
HOSE,BTP,2022-11-22,0,4020000,0,0,0,4020000,23950774,
HOSE,BTT,2022-11-22,0,48060000,0,0,0,48060000,5949557,
HOSE,VSI,2022-11-22,0,0,0,11200000,0,-11200000,6375240,
HOSE,OPC,2022-11-22,0,0,0,4480000,0,-4480000,6375240,
HOSE,BRC,2022-11-22,0,1060000,0,0,0,1060000,6126478,
HOSE,PGI,2022-11-22,0,0,0,662500,0,-662500,88087123,
HOSE,VTB,2022-11-22,0,0,0,11300000,0,-11300000,5316365,
HOSE,POM,2022-11-22,0,13104000,0,0,0,13104000,114847776,
HOSE,PNC,2022-11-22,0,0,0,6560000,0,-6560000,5322491,
HOSE,ASG,2022-11-22,0,2520000,0,0,0,2520000,22052039,
HOSE,PTL,2022-11-22,0,0,0,8710000,0,-8710000,22052039,
HOSE,PSH,2022-11-22,0,0,0,0,0,0,22052039,
HOSE,PIT,2022-11-22,0,6720000,0,0,0,6720000,7326218,
HOSE,BCE,2022-11-22,0,4352000,0,0,0,4352000,16668088,
HOSE,PGV,2022-11-22,0,17250000,0,0,0,17250000,561547123,
HOSE,PMG,2022-11-22,0,0,0,16125000,0,-16125000,11037825,
HOSE,BBC,2022-11-22,0,27720000,0,0,0,27720000,9223079,
HOSE,PJT,2022-11-22,0,0,0,81000,0,-81000,9223079,
HOSE,TDW,2022-11-22,0,4325000,0,0,0,4325000,4016420,
HOSE,TDP,2022-11-22,0,0,0,141000000,0,-141000000,30684004,
HOSE,TDH,2022-11-22,0,2950000,0,0,0,2950000,53704099,
HOSE,TIX,2022-11-22,0,0,0,61400000,0,-61400000,53704099,
HOSE,THI,2022-11-22,0,0,0,2300000,0,-2300000,23887340,
HOSE,TGG,2022-11-22,0,0,0,14518400,0,-14518400,23887340,
HOSE,ACB,2022-11-22,0,638600,0,0,0,638600,23887340,
HOSE,TCB,2022-11-22,0,227000000,0,0,0,227000000,23887340,
HOSE,TBC,2022-11-22,0,0,0,41250000,0,-41250000,30613186,
HOSE,TDG,2022-11-22,0,0,0,1190000,0,-1190000,30613186,
HOSE,TSC,2022-11-22,0,0,0,240900,0,-240900,30613186,
HOSE,TCO,2022-11-22,0,8920000,0,0,0,8920000,8714944,
HOSE,TLD,2022-11-22,0,0,0,3200,0,-3200,36151355,
HOSE,ABR,2022-11-22,0,972000,0,0,0,972000,10248700,
HOSE,TNC,2022-11-22,0,0,0,15900000,0,-15900000,9324510,
HOSE,TNA,2022-11-22,0,7440000,0,0,0,7440000,22545851,
HOSE,TPC,2022-11-22,0,10880000,0,544000,0,10336000,11356790,
HOSE,AAM,2022-11-22,0,0,0,13980000,0,-13980000,5929073,
HOSE,TNT,2022-11-22,0,0,0,1555000,0,-1555000,24960840,
HOSE,TMP,2022-11-22,0,35350000,0,0,0,35350000,33912380,
HOSE,TRC,2022-11-22,0,0,0,9180000,0,-9180000,14480450,
HOSE,ABS,2022-11-22,0,0,0,0,0,0,14480450,
HOSE,TN1,2022-11-22,0,0,0,1890000,0,-1890000,21533302,
HOSE,TMT,2022-11-22,0,840000,0,0,0,840000,17187187,
HOSE,TMS,2022-11-22,0,0,0,41340000,0,-41340000,5585560,
HOSE,SZL,2022-11-22,0,0,0,46300,0,-46300,5585560,
HOSE,SHP,2022-11-22,0,12800000,0,0,0,12800000,44323210,
HOSE,TTE,2022-11-22,0,1130000,0,0,0,1130000,14242930,
HOSE,SHA,2022-11-22,0,12950000,0,0,0,12950000,16070038,
HOSE,SMA,2022-11-22,0,1256000,0,20724000,0,-19468000,9958486,
HOSE,SJS,2022-11-22,0,0,0,93840000,0,-93840000,56442548,
HOSE,SII,2022-11-22,0,0,0,20800000,0,-20800000,691605,
HOSE,SFG,2022-11-22,0,7890000,0,0,0,7890000,23130744,
HOSE,SFC,2022-11-22,0,0,0,1900000,0,-1900000,5440089,
HOSE,TTF,2022-11-22,0,202230000,0,1569834000,0,-1367604000,202096861,
HOSE,SGT,2022-11-22,0,0,0,280800,0,-280800,202096861,
HOSE,SGR,2022-11-22,0,0,0,3660000,0,-3660000,29396226,
HOSE,SFI,2022-11-22,0,3185000,0,0,0,3185000,9081207,
HOSE,AGM,2022-11-22,0,0,0,6450000,0,-6450000,9081207,
HOSE,ADG,2022-11-22,0,2950000,0,0,0,2950000,3840301,
HOSE,STG,2022-11-22,0,0,0,8170000,0,-8170000,48078780,
HOSE,ST8,2022-11-22,0,0,0,0,0,0,48078780,
HOSE,SVI,2022-11-22,0,14380000,0,0,0,14380000,653244,
HOSE,SVD,2022-11-22,0,8370000,0,0,0,8370000,12545700,
HOSE,SVC,2022-11-22,0,0,0,11220000,0,-11220000,15705374,
HOSE,SRC,2022-11-22,0,0,0,10100000,0,-10100000,13725555,
HOSE,SPM,2022-11-22,0,0,0,2700000,0,-2700000,6588990,
HOSE,SMC,2022-11-22,0,0,0,182000,0,-182000,6588990,
HOSE,SSC,2022-11-22,0,3580000,0,0,0,3580000,7171777,
HOSE,TTB,2022-11-22,0,0,0,61800,0,-61800,7171777,
HOSE,SRF,2022-11-22,0,0,0,5050000,0,-5050000,18932307,
HOSE,NNC,2022-11-22,0,507200000,0,0,0,507200000,9092947,
HOSE,HPX,2022-11-22,0,22500000,0,0,0,22500000,112780462,
HOSE,HOT,2022-11-22,0,60300000,0,60300000,0,0,112780462,
HOSE,DAH,2022-11-22,0,0,0,173500,0,-173500,112780462,
HOSE,FCM,2022-11-22,0,191690400,0,0,0,191690400,20717399,
HOSE,CVT,2022-11-22,0,0,0,161000,0,-161000,18171580,
HOSE,HRC,2022-11-22,0,0,0,5700000,0,-5700000,14608815,
HOSE,DC4,2022-11-22,0,0,0,444000,0,-444000,26196671,
HOSE,DCL,2022-11-22,0,0,0,89964000,0,-89964000,26196671,
HOSE,VRC,2022-11-22,0,6057000,0,0,0,6057000,24271414,
HOSE,DAT,2022-11-22,0,0,0,1530000,0,-1530000,24271414,
HOSE,HHP,2022-11-22,0,900000,0,0,0,900000,13941007,
HOSE,DBT,2022-11-22,0,0,0,2400000,0,-2400000,13941007,
HOSE,COM,2022-11-22,0,6320000,0,0,0,6320000,6870247,
HOSE,HVH,2022-11-22,0,5010000,0,0,0,5010000,17900752,
HOSE,CRC,2022-11-22,0,530000,0,0,0,530000,14902730,
HOSE,ICT,2022-11-22,0,7225000,0,0,0,7225000,32028428,
HOSE,IBC,2022-11-22,0,15800000,0,6320000,0,9480000,25723618,
HOSE,HVX,2022-11-22,0,2169000,0,0,0,2169000,19244101,
HOSE,CSM,2022-11-22,0,0,0,42000000,0,-42000000,51054689,
HOSE,HTL,2022-11-22,0,1535000,0,0,0,1535000,353581,
HOSE,HTI,2022-11-22,0,171200000,0,0,0,171200000,6900701,
HOSE,CRE,2022-11-22,0,0,0,5250000,0,-5250000,222123352,
HOSE,HU1,2022-11-22,0,1050000,0,0,0,1050000,4651370,
HOSE,HTV,2022-11-22,0,9920000,0,0,0,9920000,4928486,
HOSE,GAB,2022-11-22,0,0,0,0,0,0,4425748,
HOSE,DRL,2022-11-22,0,0,0,1334000,0,-1334000,4425748,
HOSE,VNL,2022-11-22,0,33490000,0,0,0,33490000,3735120,
HOSE,GMC,2022-11-22,0,5700000,0,11400000,0,-5700000,13418778,
HOSE,VMD,2022-11-22,0,51900000,0,0,0,51900000,7345150,
HOSE,DMC,2022-11-22,0,38610000,0,0,0,38610000,15589890,
HOSE,DTA,2022-11-22,0,5490000,0,0,0,5490000,8825251,
HOSE,DTL,2022-11-22,0,0,0,683800,0,-683800,30102450,
HOSE,DTT,2022-11-22,0,0,0,0,0,0,3975195,
HOSE,FUEIP100,2022-11-22,0,9772000,0,0,0,9772000,5655100,
HOSE,FUCTVGF4,2022-11-22,0,0,0,0,0,0,9829400,
HOSE,FUCTVGF3,2022-11-22,0,0,0,0,0,0,9751392,
HOSE,HAS,2022-11-22,0,837000,0,0,0,837000,2584159,
HOSE,DVP,2022-11-22,2200,93500000,2200,93500000,0,0,14692319,
HOSE,FDC,2022-11-22,0,0,0,7170600,0,-7170600,19308250,
HOSE,HCD,2022-11-22,0,0,0,10185000,0,-10185000,15450682,
HOSE,VID,2022-11-22,0,0,0,602000,0,-602000,20233544,
HOSE,VIP,2022-11-22,0,0,0,1237872000,0,-1237872000,31950096,
HOSE,GMH,2022-11-22,0,6400000,0,0,0,6400000,8242700,
HOSE,VPS,2022-11-22,0,32400000,0,0,0,32400000,11819623,
HOSE,FIT,2022-11-22,0,0,0,234080,0,-234080,11819623,
HOSE,DHM,2022-11-22,0,0,0,2967000,0,-2967000,11819623,
HOSE,GTA,2022-11-22,0,0,0,116000,0,-116000,5036715,
HOSE,GSP,2022-11-22,0,0,0,0,0,0,5036715,
HOSE,VPD,2022-11-22,0,0,0,6165000,0,-6165000,52174759,
HOSE,LSS,2022-11-22,0,0,0,3330000,0,-3330000,52174759,
HOSE,VCA,2022-11-22,0,996000,0,0,0,996000,6152725,
HOSE,MCP,2022-11-22,0,0,0,359100,0,-359100,7361080,
HOSE,MCG,2022-11-22,0,546000,0,0,0,546000,28069591,
HOSE,CCI,2022-11-22,0,0,0,87000000,0,-87000000,28069591,
HOSE,LGC,2022-11-22,0,0,0,44010000,0,-44010000,7738849,
HOSE,LEC,2022-11-22,0,0,0,15572000,0,-15572000,12785977,
HOSE,VCF,2022-11-22,0,43220000,0,0,0,43220000,12847941,
HOSE,LM8,2022-11-22,0,0,0,12870000,0,-12870000,12847941,
HOSE,CCL,2022-11-22,0,14280000,0,0,0,14280000,26127265,
HOSE,LGL,2022-11-22,0,32100000,0,0,0,32100000,24292973,
HOSE,MDG,2022-11-22,0,21720000,0,0,0,21720000,5334225,
HOSE,EMC,2022-11-22,0,0,0,0,0,0,5334225,
HOSE,NCT,2022-11-22,0,0,0,76230000,0,-76230000,4627364,
HOSE,C32,2022-11-22,0,14000000,0,0,0,14000000,6695353,
HOSE,UIC,2022-11-22,0,0,0,350000,0,-350000,6695353,
HOSE,HU3,2022-11-22,0,719000,0,0,0,719000,4430782,
HOSE,VAF,2022-11-22,0,0,0,56700000,0,-56700000,18440186,
HOSE,C47,2022-11-22,0,0,0,423950,0,-423950,18440186,
HOSE,CAV,2022-11-22,0,0,0,2387500,0,-2387500,28094952,
HOSE,MHC,2022-11-22,0,1640000,0,0,0,1640000,19362894,
HOSE,NAV,2022-11-22,0,18400000,0,0,0,18400000,3841253,
HOSE,NAF,2022-11-22,0,25020000,0,0,0,25020000,46734000,
HOSE,MWG,2022-11-22,0,4065000000,0,4065000000,0,0,46734000,
HOSE,KHP,2022-11-22,0,0,0,184100000,0,-184100000,28405439,
HOSE,CLL,2022-11-22,0,12275000,0,0,0,12275000,14269539,
HOSE,CLW,2022-11-22,0,37000000,0,0,0,37000000,5737010,
HOSE,CIG,2022-11-22,0,0,0,208500000,0,-208500000,15443761,
HOSE,CKG,2022-11-22,0,0,0,379320000,0,-379320000,15443761,
HOSE,CLC,2022-11-22,0,46130000,0,0,0,46130000,12281554,
HOSE,IMP,2022-11-22,0,0,0,263105200,0,-263105200,16785747,
HOSE,ILB,2022-11-22,0,551475000,0,0,0,551475000,11635900,
HOSE,VFG,2022-11-22,0,0,0,86900,0,-86900,19340633,
HOSE,CMV,2022-11-22,0,0,0,1420000,0,-1420000,19340633,
HOSE,VDP,2022-11-22,0,0,0,0,0,0,19340633,
HOSE,ITC,2022-11-22,0,0,0,1150000,0,-1150000,19340633,
HOSE,L10,2022-11-22,0,0,0,0,0,0,4723147,
HOSE,LAF,2022-11-22,0,0,0,0,0,0,6935865,
HOSE,CHP,2022-11-22,0,0,0,398899200,0,-398899200,6935865,
HOSE,EVG,2022-11-22,0,0,0,8932000,0,-8932000,105276447,
HOSE,BMC,2022-11-22,800,9240000,1100,12705000,-300,-3465000,5285587,
HOSE,ACG,2022-11-22,300,10770000,600,21540000,-300,-10770000,15524342,
HOSE,THG,2022-11-22,300,10635000,600,21270000,-300,-10635000,9649160,
HOSE,NHT,2022-11-22,0,0,400,5760000,-400,-5760000,8359563,
HOSE,TNI,2022-11-22,0,0,500,1525000,-500,-1525000,25565990,
HOSE,VPG,2022-11-22,1700,22695000,2250,30037500,-550,-7342500,38904033,
HOSE,AGG,2022-11-22,1400,46900000,2100,70350000,-700,-23450000,50338450,
HOSE,OGC,2022-11-22,3400,23800000,4300,30100000,-900,-6300000,146516658,
HOSE,CMX,2022-11-22,9000,59400000,9901,65346600,-901,-5946600,40914766,
HOSE,FUCVREIT,2022-11-22,0,0,1000,6890000,-1000,-6890000,2347610,
HOSE,HMC,2022-11-22,0,0,1000,8900000,-1000,-8900000,2347610,
HOSE,ACC,2022-11-22,0,0,1000,10850000,-1000,-10850000,42689787,
HOSE,SC5,2022-11-22,0,0,1100,17820000,-1100,-17820000,6723424,
HOSE,VTO,2022-11-22,3100,21700000,4200,29400000,-1100,-7700000,38162625,
HOSE,DQC,2022-11-22,0,0,1300,18590000,-1300,-18590000,16524989,
HOSE,TIP,2022-11-22,700,11025000,2100,33075000,-1400,-22050000,21273357,
HOSE,HSL,2022-11-22,0,0,1600,5952000,-1600,-5952000,16590840,
HOSE,SJF,2022-11-22,1000,3300000,3000,9900000,-2000,-6600000,38290656,
HOSE,PTC,2022-11-22,0,0,2000,9980000,-2000,-9980000,15811732,
HOSE,ACL,2022-11-22,0,0,2100,21735000,-2100,-21735000,18244160,
HOSE,FUEDCMID,2022-11-22,2800,20104000,5000,35900000,-2200,-15796000,1144475,
HOSE,DAG,2022-11-22,0,0,3800,13984000,-3800,-13984000,29020126,
HOSE,HAR,2022-11-22,0,0,4300,14835000,-4300,-14835000,49438985,
HOSE,HID,2022-11-22,0,0,4400,12012000,-4400,-12012000,37083292,
HOSE,ELC,2022-11-22,5300,42400000,9800,78400000,-4500,-36000000,22728956,
HOSE,VSH,2022-11-22,37,1080400,5000,146000000,-4963,-144919600,88456210,
HOSE,PLP,2022-11-22,500,2185000,5700,24909000,-5200,-22724000,33359534,
HOSE,TCR,2022-11-22,7000,19880000,12200,34648000,-5200,-14768000,289216,
HOSE,PHC,2022-11-22,0,0,5300,30740000,-5300,-30740000,24664057,
HOSE,PPC,2022-11-22,3800,47120000,10100,125240000,-6300,-78120000,117218454,
HOSE,CTS,2022-11-22,10200,91290000,16810,150449500,-6610,-59159500,70085560,
HOSE,SZC,2022-11-22,5900,155465000,12600,332010000,-6700,-176545000,46186840,
HOSE,HAH,2022-11-22,59070,1662820500,66460,1870849000,-7390,-208028500,24466883,
HOSE,NHA,2022-11-22,900,9540000,8400,89040000,-7500,-79500000,20447791,
HOSE,YEG,2022-11-22,2000,18300000,10300,94245000,-8300,-75945000,26300724,
HOSE,JVC,2022-11-22,4500,14085000,12800,40064000,-8300,-25979000,53620919,
HOSE,IDI,2022-11-22,17800,148630000,26600,222110000,-8800,-73480000,109073220,
HOSE,SAM,2022-11-22,700,4452000,11200,71232000,-10500,-66780000,183442300,
HOSE,TLH,2022-11-22,2600,14664000,13500,76140000,-10900,-61476000,48733611,
HOSE,IJC,2022-11-22,20800,223600000,32400,348300000,-11600,-124700000,92428567,
HOSE,UDC,2022-11-22,6200,39060000,18000,113400000,-11800,-74340000,12819620,
HOSE,DPM,2022-11-22,709000,25524000000,721750,25983000000,-12750,-459000000,120395805,
HOSE,DLG,2022-11-22,0,0,16200,32562000,-16200,-32562000,141344633,
HOSE,HUB,2022-11-22,0,0,22600,293800000,-22600,-293800000,141344633,
HOSE,BSI,2022-11-22,16700,250500000,40100,601500000,-23400,-351000000,117753429,
HOSE,BMI,2022-11-22,5500,108350000,30055,592083500,-24555,-483733500,18398937,
HOSE,FUEKIVFS,2022-11-22,0,0,25000,183750000,-25000,-183750000,803300,
HOSE,DRH,2022-11-22,0,0,27400,90420000,-27400,-90420000,60565759,
HOSE,HQC,2022-11-22,48400,105996000,77500,169725000,-29100,-63729000,226208661,
HOSE,VOS,2022-11-22,1800,13680000,31700,240920000,-29900,-227240000,66932890,
HOSE,TDC,2022-11-22,8400,72660000,42100,364165000,-33700,-291505000,48418750,
HOSE,GVR,2022-11-22,51900,653940000,88405,1113903000,-36505,-459963000,497807420,
HOSE,APH,2022-11-22,6000,43200000,46600,335520000,-40600,-292320000,172690033,
HOSE,FCN,2022-11-22,53100,408870000,97900,753830000,-44800,-344960000,27645542,
HOSE,AMD,2022-11-22,900,1035000,58700,67505000,-57800,-66470000,78164991,
HOSE,LPB,2022-11-22,2750,27390000,69000,687240000,-66250,-659850000,50,
HOSE,HHV,2022-11-22,900,7218000,74500,597490000,-73600,-590272000,124400855,
HOSE,HBC,2022-11-22,21900,174981000,98656,788261440,-76756,-613280440,90533746,
HOSE,VSC,2022-11-22,5000,164500000,85735,2820681500,-80735,-2656181500,53857416,
HOSE,GAS,2022-11-22,76400,8342880000,165900,18116280000,-89500,-9773400000,880324951,
HOSE,SSB,2022-11-22,29900,891020000,127700,3805460000,-97800,-2914440000,95381786,
HOSE,SHB,2022-11-22,204200,2123680000,305600,3178240000,-101400,-1054560000,662230049,
HOSE,HAX,2022-11-22,7873,115733100,116900,1718430000,-109027,-1602696900,10713273,
HOSE,GIL,2022-11-22,1900,39330000,115713,2395259100,-113813,-2355929100,31987103,
HOSE,BAF,2022-11-22,9100,158795000,125600,2191720000,-116500,-2032925000,70669644,
HOSE,HCM,2022-11-22,178300,3387700000,299527,5691013000,-121227,-2303313000,37930736,
HOSE,LDG,2022-11-22,6100,26230000,146500,629950000,-140400,-603720000,117924278,
HOSE,SCR,2022-11-22,32400,165564000,179700,918267000,-147300,-752703000,189341943,
HOSE,PTB,2022-11-22,21200,791820000,187960,7020306000,-166760,-6228486000,5611868,
HOSE,LCG,2022-11-22,4500,25200000,175500,982800000,-171000,-957600000,91145729,
HOSE,NLG,2022-11-22,3132700,72365370000,3320300,76698930000,-187600,-4333560000,24847681,
HOSE,NTL,2022-11-22,0,0,260800,4381440000,-260800,-4381440000,22598895,
HOSE,VCB,2022-11-22,1126000,82761000000,1424200,104678700000,-298200,-21917700000,302314308,
HOSE,DIG,2022-11-22,388200,5046600000,802405,10431265000,-414205,-5384665000,273893359,
HOSE,PC1,2022-11-22,175800,2847960000,613727,9942377400,-437927,-7094417400,103797771,
HOSE,FTS,2022-11-22,20639,337447650,507720,8301222000,-487081,-7963774350,144918535,
HOSE,CTG,2022-11-22,1204203,28780451700,1802412,43077646800,-598209,-14297195100,131522703,
HOSE,KBC,2022-11-22,514100,8662585000,1201600,20246960000,-687500,-11584375000,246146274,
HOSE,NKG,2022-11-22,68100,626520000,868312,7988470400,-800212,-7361950400,102339784,
HOSE,HSG,2022-11-22,136200,1253040000,1013505,9324246000,-877305,-8071206000,256377239,
HOSE,VND,2022-11-22,1683800,19026940000,2665215,30116929500,-981415,-11089989500,999326076,
HOSE,STB,2022-11-22,2461700,41602730000,3577506,60459851400,-1115806,-18857121400,129537376,
HOSE,HAG,2022-11-22,54300,423540000,1189606,9278926800,-1135306,-8855386800,433582979,
HOSE,NVL,2022-11-22,1534990,38911996500,2717120,68878992000,-1182130,-29966995500,850403394,
HOSE,DGC,2022-11-22,687600,35136360000,2031300,103799430000,-1343700,-68663070000,122691242,
HOSE,DXG,2022-11-22,884500,9021900000,2723705,27781791000,-1839205,-18759891000,140252274,
HOSE,GEX,2022-11-22,160200,2026530000,2050300,25936295000,-1890100,-23909765000,345057303,
HOSE,E1VFVN30,2022-11-22,3239200,52215904000,5329800,85916376000,-2090600,-33700472000,32359420,
